1000000000000001
S*00010000000001
1*11110111111101
1*00000100000101
1*11110101110101
1*10000101000101
1*10111101011101
1*10100001010001
1*10101111010111
1*10101000000101
1*10101011111101
1*10001000000001
1*11111110111101
1*******10100001
1011111*10001101
1000000********E
